#epoch, step, actionA, actionB, reward_n, game_dif_score, playerA_score, playerB_score, epsilon
0,1786,9,30,0,-3,12,15,1.0
1,3572,15,23,0,4,13,9,1.0
2,5358,12,26,0,-12,8,20,0.99919675
3,7144,11,22,0,-10,6,16,0.99839305
4,8930,2,24,0,8,17,9,0.99758935
5,10716,14,32,0,3,12,9,0.99678565
6,12502,17,28,0,12,19,7,0.99598195
7,14288,1,18,0,17,28,11,0.99517825
8,16074,0,19,0,9,16,7,0.994374549999
9,17860,12,30,0,-4,12,16,0.993570849999
10,19646,7,33,0,-1,2,3,0.992767149999
11,21432,2,30,0,1,5,4,0.991963449999
12,23218,13,29,0,3,13,10,0.991159749999
13,25004,14,26,0,0,2,2,0.990356049999
14,26790,5,27,0,-1,7,8,0.989552349999
15,28576,2,28,0,0,11,11,0.988748649999
16,30362,17,31,0,0,8,8,0.987944949999
17,32148,15,19,0,-9,7,16,0.987141249999
18,33934,9,23,0,-1,11,12,0.986337549999
19,35720,15,23,0,1,10,9,0.985533849999
20,37506,6,33,0,0,8,8,0.984730149999
21,39292,1,33,0,2,12,10,0.983926449999
22,41078,2,28,0,-2,7,9,0.983122749998
23,42864,8,28,0,-1,10,11,0.982319049998
24,44650,5,30,0,-4,11,15,0.981515349998
25,46436,10,19,0,4,12,8,0.980711649998
26,48222,12,34,0,4,18,14,0.979907949998
27,50008,3,25,0,5,22,17,0.979104249998
28,51794,11,25,0,1,6,5,0.978300549998
29,53580,6,18,0,10,25,15,0.977496849998
30,55366,12,28,0,-2,14,16,0.976693149998
31,57152,14,21,0,-3,3,6,0.975889449998
32,58938,8,22,0,-8,12,20,0.975085749998
33,60724,2,29,0,1,3,2,0.974282049998
34,62510,0,26,0,6,22,16,0.973478349998
35,64296,6,22,0,0,20,20,0.972674649998
36,66082,15,19,0,-5,5,10,0.971870949997
37,67868,6,21,0,6,8,2,0.971067249997
38,69654,11,19,0,3,16,13,0.970263549997
39,71440,14,25,0,6,10,4,0.969459849997
40,73226,11,18,0,-2,11,13,0.968656149997
41,75012,13,32,0,-4,4,8,0.967852449997
42,76798,11,21,0,3,6,3,0.967048749997
43,78584,1,22,0,0,7,7,0.966245049997
44,80370,7,34,0,7,18,11,0.965441349997
45,82156,12,25,0,0,8,8,0.964637649997
46,83942,3,29,0,-1,13,14,0.963833949997
47,85728,8,18,0,1,1,0,0.963030249997
48,87514,0,21,0,-4,6,10,0.962226549997
49,89300,11,20,0,0,3,3,0.961422849997
50,91086,7,18,0,7,11,4,0.960619149996
51,92872,15,29,0,6,21,15,0.959815449996
52,94658,17,30,0,3,12,9,0.959011749996
53,96444,13,18,0,-1,15,16,0.958208049996
54,98230,7,29,0,4,8,4,0.957404349996
55,100016,5,33,0,4,12,8,0.956600649996
56,101802,8,19,0,-5,8,13,0.955796949996
57,103588,0,32,0,-2,9,11,0.954993249996
58,105374,15,22,0,-8,4,12,0.954189549996
59,107160,12,31,0,-5,6,11,0.953385849996
60,108946,17,20,0,-9,6,15,0.952582149996
61,110732,17,24,0,-4,16,20,0.951778449996
62,112518,17,19,0,10,20,10,0.950974749996
63,114304,6,23,0,2,3,1,0.950171049995
64,116090,11,20,0,1,12,11,0.949367349995
65,117876,0,32,0,-6,4,10,0.948563649995
66,119662,0,23,0,-3,11,14,0.947759949995
67,121448,16,24,0,0,8,8,0.946956249995
68,123234,11,27,0,3,8,5,0.946152549995
69,125020,7,26,0,14,21,7,0.945348849995
70,126806,2,26,0,0,6,6,0.944545149995
71,128592,9,27,0,-4,2,6,0.943741449995
72,130378,7,18,0,2,3,1,0.942937749995
73,132164,16,27,0,1,4,3,0.942134049995
74,133950,17,31,0,-1,0,1,0.941330349995
75,135736,0,27,0,-4,3,7,0.940526649995
76,137522,12,30,0,0,0,0,0.939722949995
77,139308,11,23,0,0,8,8,0.938919249994
78,141094,16,29,0,-2,11,13,0.938115549994
79,142880,5,19,0,3,14,11,0.937311849994
80,144666,8,34,0,-2,7,9,0.936508149994
81,146452,12,24,0,1,6,5,0.935704449994
82,148238,0,21,0,-1,5,6,0.934900749994
83,150024,15,20,0,14,18,4,0.934097049994
84,151810,13,18,0,7,8,1,0.933293349994
85,153596,9,28,0,-1,9,10,0.932489649994
86,155382,11,22,0,5,12,7,0.931685949994
87,157168,7,20,0,1,13,12,0.930882249994
88,158954,12,28,0,-2,10,12,0.930078549994
89,160740,9,23,0,-2,3,5,0.929274849994
90,162526,3,31,0,4,9,5,0.928471149994
91,164312,17,28,0,0,9,9,0.927667449993
92,166098,3,32,0,-2,7,9,0.926863749993
93,167884,7,26,0,-2,8,10,0.926060049993
94,169670,4,31,0,-7,5,12,0.925256349993
95,171456,17,18,0,-4,14,18,0.924452649993
96,173242,16,27,0,5,17,12,0.923648949993
97,175028,17,33,0,0,4,4,0.922845249993
98,176814,11,32,0,6,14,8,0.922041549993
99,178600,2,30,0,-1,4,5,0.921237849993
100,180386,3,35,0,-3,5,8,0.920434149993
101,182172,0,19,0,3,14,11,0.919630449993
102,183958,3,19,0,1,5,4,0.918826749993
103,185744,8,35,0,2,13,11,0.918023049993
104,187530,2,34,0,-3,5,8,0.917219349993
105,189316,8,30,0,-4,0,4,0.916415649992
106,191102,13,33,0,-4,8,12,0.915611949992
107,192888,0,19,0,2,11,9,0.914808249992
108,194674,9,20,0,-1,10,11,0.914004549992
109,196460,14,21,0,-1,11,12,0.913200849992
110,198246,15,30,0,3,7,4,0.912397149992
111,200032,10,26,0,3,8,5,0.911593449992
112,201818,10,21,0,-19,31,50,0.910789749992
113,203604,0,31,0,2,41,39,0.909986049992
114,205390,7,25,0,2,8,6,0.909182349992
115,207176,2,35,0,-11,19,30,0.908378649992
116,208962,8,30,0,3,6,3,0.907574949992
117,210748,8,19,0,0,1,1,0.906771249992
118,212534,14,25,0,-8,30,38,0.905967549991
119,214320,14,25,0,-1,1,2,0.905163849991
120,216106,11,25,0,-1,5,6,0.904360149991
121,217892,9,23,0,3,26,23,0.903556449991
122,219678,6,25,0,0,3,3,0.902752749991
123,221464,8,30,0,-9,11,20,0.901949049991
124,223250,16,19,0,3,7,4,0.901145349991
125,225036,12,19,0,9,21,12,0.900341649991
126,226822,0,32,0,-9,4,13,0.899537949991
127,228608,0,27,0,-6,12,18,0.898734249991
128,230394,12,23,0,4,6,2,0.897930549991
129,232180,16,20,0,-5,7,12,0.897126849991
130,233966,6,33,0,0,4,4,0.896323149991
131,235752,12,31,0,0,14,14,0.895519449991
132,237538,16,24,0,6,12,6,0.89471574999
133,239324,0,29,0,10,25,15,0.89391204999
134,241110,0,19,0,8,18,10,0.89310834999
135,242896,16,20,0,-12,27,39,0.89230464999
136,244682,15,28,0,-3,10,13,0.89150094999
137,246468,11,18,0,-2,0,2,0.89069724999
138,248254,9,31,0,-4,12,16,0.88989354999
139,250040,8,33,0,0,3,3,0.88908984999
140,251826,7,24,0,-2,6,8,0.88828614999
141,253612,7,23,0,0,0,0,0.88748244999
142,255398,12,29,0,5,13,8,0.88667874999
143,257184,7,35,0,2,18,16,0.88587504999
144,258970,5,18,0,5,15,10,0.88507134999
145,260756,3,21,0,-1,12,13,0.88426764999
146,262542,10,35,0,-4,4,8,0.883463949989
147,264328,15,25,0,-9,4,13,0.882660249989
148,266114,6,23,0,2,9,7,0.881856549989
149,267900,3,26,0,6,8,2,0.881052849989
150,269686,5,21,0,0,4,4,0.880249149989
151,271472,8,31,0,0,0,0,0.879445449989
152,273258,9,20,0,2,7,5,0.878641749989
153,275044,3,21,0,-5,1,6,0.877838049989
154,276830,15,31,0,4,19,15,0.877034349989
155,278616,10,31,0,5,13,8,0.876230649989
156,280402,4,29,0,6,13,7,0.875426949989
157,282188,3,25,0,3,5,2,0.874623249989
158,283974,0,30,0,-1,0,1,0.873819549989
159,285760,14,24,0,-7,1,8,0.873015849989
160,287546,17,30,0,-1,1,2,0.872212149988
161,289332,11,21,0,-2,8,10,0.871408449988
162,291118,16,34,0,0,0,0,0.870604749988
163,292904,2,19,0,21,45,24,0.869801049988
164,294690,0,34,0,-4,0,4,0.868997349988
165,296476,2,27,0,4,10,6,0.868193649988
166,298262,11,26,0,1,5,4,0.867389949988
167,300048,0,31,0,1,5,4,0.866586249988
168,301834,10,29,0,-7,22,29,0.865782549988
169,303620,6,22,0,-4,0,4,0.864978849988
170,305406,9,22,0,8,13,5,0.864175149988
171,307192,7,20,0,4,9,5,0.863371449988
172,308978,13,28,0,-5,3,8,0.862567749988
173,310764,4,35,0,-2,3,5,0.861764049987
174,312550,4,22,0,-6,7,13,0.860960349987
175,314336,4,30,0,-1,6,7,0.860156649987
176,316122,15,21,0,-6,9,15,0.859352949987
177,317908,15,29,0,18,26,8,0.858549249987
178,319694,4,26,0,4,12,8,0.857745549987
179,321480,17,22,0,5,5,0,0.856941849987
180,323266,4,19,0,-1,2,3,0.856138149987
181,325052,10,35,0,-2,4,6,0.855334449987
182,326838,15,22,0,-1,0,1,0.854530749987
183,328624,4,29,0,0,0,0,0.853727049987
184,330410,15,28,0,0,0,0,0.852923349987
185,332196,1,23,0,-1,7,8,0.852119649987
186,333982,6,25,0,0,0,0,0.851315949987
187,335768,3,28,0,0,0,0,0.850512249986
188,337554,0,19,0,3,5,2,0.849708549986
189,339340,9,27,0,8,17,9,0.848904849986
190,341126,16,20,0,-10,7,17,0.848101149986
191,342912,12,23,0,-3,13,16,0.847297449986
192,344698,0,19,0,5,10,5,0.846493749986
193,346484,4,31,0,-1,3,4,0.845690049986
194,348270,0,19,0,1,4,3,0.844886349986
195,350056,3,28,0,10,21,11,0.844082649986
196,351842,12,33,0,3,8,5,0.843278949986
197,353628,13,33,0,4,13,9,0.842475249986
198,355414,10,29,0,7,21,14,0.841671549986
199,357200,2,25,0,5,12,7,0.840867849986
200,358986,10,29,0,-5,5,10,0.840064149986
201,360772,7,27,0,6,11,5,0.839260449985
202,362558,7,26,0,0,3,3,0.838456749985
203,364344,1,22,0,11,14,3,0.837653049985
204,366130,17,18,0,2,4,2,0.836849349985
205,367916,1,24,0,0,1,1,0.836045649985
206,369702,0,27,0,-3,3,6,0.835241949985
207,371488,9,33,0,8,11,3,0.834438249985
208,373274,0,29,0,0,2,2,0.833634549985
209,375060,12,35,0,-3,0,3,0.832830849985
210,376846,6,29,0,-4,4,8,0.832027149985
211,378632,6,23,0,1,6,5,0.831223449985
212,380418,6,35,0,-9,4,13,0.830419749985
213,382204,0,35,0,4,12,8,0.829616049985
214,383990,13,32,0,-1,0,1,0.828812349985
215,385776,8,33,0,2,8,6,0.828008649984
216,387562,6,30,0,0,0,0,0.827204949984
217,389348,0,35,0,4,5,1,0.826401249984
218,391134,5,24,0,-2,0,2,0.825597549984
219,392920,0,29,0,0,7,7,0.824793849984
220,394706,4,35,0,-3,0,3,0.823990149984
221,396492,16,28,0,-3,1,4,0.823186449984
222,398278,4,19,0,5,14,9,0.822382749984
223,400064,0,22,0,-6,3,9,0.821579049984
224,401850,0,24,0,2,10,8,0.820775349984
225,403636,0,24,0,1,1,0,0.819971649984
226,405422,8,24,0,7,10,3,0.819167949984
227,407208,10,24,0,-4,2,6,0.818364249984
228,408994,8,29,0,3,5,2,0.817560549984
229,410780,3,27,0,-4,2,6,0.816756849983
230,412566,0,24,0,3,6,3,0.815953149983
231,414352,0,24,0,0,0,0,0.815149449983
232,416138,16,32,0,-3,2,5,0.814345749983
233,417924,0,18,0,12,14,2,0.813542049983
234,419710,2,21,0,4,9,5,0.812738349983
235,421496,1,30,0,-1,13,14,0.811934649983
236,423282,0,31,0,-7,6,13,0.811130949983
237,425068,13,18,0,-1,1,2,0.810327249983
238,426854,0,19,0,2,10,8,0.809523549983
239,428640,6,18,0,0,9,9,0.808719849983
240,430426,17,21,0,18,23,5,0.807916149983
241,432212,0,30,0,0,12,12,0.807112449983
242,433998,1,18,0,-6,10,16,0.806308749982
243,435784,0,33,0,-3,3,6,0.805505049982
244,437570,14,18,0,2,8,6,0.804701349982
245,439356,0,18,0,-1,4,5,0.803897649982
246,441142,0,31,0,11,13,2,0.803093949982
247,442928,9,18,0,-6,7,13,0.802290249982
248,444714,17,18,0,4,8,4,0.801486549982
249,446500,17,28,0,-6,5,11,0.800682849982
250,448286,8,34,0,0,11,11,0.799879149982
251,450072,11,33,0,-2,5,7,0.799075449982
252,451858,0,31,0,2,11,9,0.798271749982
253,453644,16,20,0,5,17,12,0.797468049982
254,455430,3,18,0,0,6,6,0.796664349982
255,457216,7,30,0,12,22,10,0.795860649982
256,459002,7,31,0,-1,11,12,0.795056949981
257,460788,1,29,0,6,13,7,0.794253249981
258,462574,11,23,0,2,6,4,0.793449549981
259,464360,0,20,0,2,8,6,0.792645849981
260,466146,0,34,0,-3,5,8,0.791842149981
261,467932,13,30,0,0,0,0,0.791038449981
262,469718,5,34,0,0,0,0,0.790234749981
263,471504,0,18,0,0,2,2,0.789431049981
264,473290,11,23,0,5,10,5,0.788627349981
265,475076,0,18,0,1,5,4,0.787823649981
266,476862,0,18,0,-1,4,5,0.787019949981
267,478648,12,20,0,9,13,4,0.786216249981
268,480434,0,25,0,5,8,3,0.785412549981
269,482220,15,30,0,1,1,0,0.784608849981
270,484006,0,32,0,3,4,1,0.78380514998
271,485792,8,31,0,-5,1,6,0.78300144998
272,487578,7,32,0,0,0,0,0.78219774998
273,489364,9,21,0,-3,1,4,0.78139404998
274,491150,7,32,0,0,6,6,0.78059034998
275,492936,1,18,0,-2,0,2,0.77978664998
276,494722,6,21,0,3,7,4,0.77898294998
277,496508,15,28,0,-2,2,4,0.77817924998
278,498294,3,18,0,-1,6,7,0.77737554998
279,500080,4,30,0,2,8,6,0.77657184998
280,501866,7,34,0,-1,0,1,0.77576814998
281,503652,0,33,0,-7,10,17,0.77496444998
282,505438,9,20,0,8,23,15,0.77416074998
283,507224,7,25,0,-4,13,17,0.77335704998
284,509010,14,29,0,10,23,13,0.772553349979
285,510796,0,19,0,5,14,9,0.771749649979
286,512582,6,21,0,-6,2,8,0.770945949979
287,514368,9,21,0,12,13,1,0.770142249979
288,516154,0,31,0,-6,0,6,0.769338549979
289,517940,0,33,0,-8,6,14,0.768534849979
290,519726,0,35,0,-8,12,20,0.767731149979
291,521512,3,28,0,4,18,14,0.766927449979
292,523298,14,34,0,5,11,6,0.766123749979
293,525084,15,20,0,-2,12,14,0.765320049979
294,526870,2,31,0,2,14,12,0.764516349979
295,528656,0,24,0,0,8,8,0.763712649979
296,530442,6,34,0,1,11,10,0.762908949979
297,532228,2,18,0,4,9,5,0.762105249978
298,534014,17,30,0,3,7,4,0.761301549978
299,535800,12,33,0,-7,22,29,0.760497849978
300,537586,0,34,0,1,25,24,0.759694149978
301,539372,16,31,0,0,7,7,0.758890449978
302,541158,0,18,0,-4,8,12,0.758086749978
303,542944,0,31,0,9,17,8,0.757283049978
304,544730,0,23,0,3,13,10,0.756479349978
305,546516,9,18,0,-3,6,9,0.755675649978
306,548302,17,28,0,-2,0,2,0.754871949978
307,550088,0,31,0,5,13,8,0.754068249978
308,551874,13,27,0,0,0,0,0.753264549978
309,553660,5,34,0,-1,5,6,0.752460849978
310,555446,17,30,0,2,13,11,0.751657149978
311,557232,0,24,0,0,0,0,0.750853449977
312,559018,2,34,0,0,1,1,0.750049749977
313,560804,11,26,0,0,3,3,0.749246049977
314,562590,5,25,0,-1,10,11,0.748442349977
315,564376,0,18,0,0,3,3,0.747638649977
316,566162,0,18,0,0,6,6,0.746834949977
317,567948,2,18,0,-1,6,7,0.746031249977
318,569734,16,18,0,-7,8,15,0.745227549977
319,571520,16,18,0,22,29,7,0.744423849977
320,573306,3,33,0,13,18,5,0.743620149977
321,575092,15,24,0,11,16,5,0.742816449977
322,576878,11,18,0,3,6,3,0.742012749977
323,578664,16,18,0,-1,2,3,0.741209049977
324,580450,15,25,0,-2,5,7,0.740405349977
325,582236,3,18,0,8,18,10,0.739601649976
326,584022,2,18,0,-10,8,18,0.738797949976
327,585808,15,35,0,-5,11,16,0.737994249976
328,587594,1,18,0,4,7,3,0.737190549976
329,589380,0,18,0,-5,4,9,0.736386849976
330,591166,0,18,0,0,6,6,0.735583149976
331,592952,2,28,0,8,12,4,0.734779449976
332,594738,13,25,0,10,12,2,0.733975749976
333,596524,0,31,0,-5,9,14,0.733172049976
334,598310,7,26,0,-3,4,7,0.732368349976
335,600096,2,26,0,-1,8,9,0.731564649976
336,601882,5,18,0,-3,1,4,0.730760949976
337,603668,1,18,0,3,7,4,0.729957249976
338,605454,0,18,0,0,0,0,0.729153549976
339,607240,9,18,0,4,9,5,0.728349849975
340,609026,13,29,0,-6,2,8,0.727546149975
341,610812,12,28,0,-6,6,12,0.726742449975
342,612598,0,18,0,1,20,19,0.725938749975
343,614384,8,23,0,-1,4,5,0.725135049975
344,616170,0,30,0,2,9,7,0.724331349975
345,617956,5,24,0,-11,6,17,0.723527649975
346,619742,11,32,0,6,16,10,0.722723949975
347,621528,0,18,0,1,7,6,0.721920249975
348,623314,6,22,0,1,9,8,0.721116549975
349,625100,0,31,0,0,7,7,0.720312849975
350,626886,0,32,0,-5,8,13,0.719509149975
351,628672,4,18,0,-2,4,6,0.718705449975
352,630458,5,22,0,2,3,1,0.717901749974
353,632244,3,31,0,9,16,7,0.717098049974
354,634030,4,18,0,4,14,10,0.716294349974
355,635816,16,25,0,5,7,2,0.715490649974
356,637602,1,35,0,5,13,8,0.714686949974
357,639388,14,26,0,5,10,5,0.713883249974
358,641174,4,31,0,5,13,8,0.713079549974
359,642960,0,18,0,0,9,9,0.712275849974
360,644746,16,26,0,1,6,5,0.711472149974
361,646532,0,34,0,-2,9,11,0.710668449974
362,648318,4,34,0,3,9,6,0.709864749974
363,650104,0,32,0,-3,0,3,0.709061049974
364,651890,0,22,0,-5,9,14,0.708257349974
365,653676,0,27,0,-1,3,4,0.707453649974
366,655462,0,18,0,-2,9,11,0.706649949973
367,657248,2,31,0,-2,3,5,0.705846249973
368,659034,0,18,0,5,10,5,0.705042549973
369,660820,0,18,0,-4,7,11,0.704238849973
370,662606,17,33,0,1,6,5,0.703435149973
371,664392,1,24,0,6,12,6,0.702631449973
372,666178,15,18,0,-2,4,6,0.701827749973
373,667964,0,18,0,6,12,6,0.701024049973
374,669750,0,18,0,-3,9,12,0.700220349973
375,671536,12,24,0,4,7,3,0.699416649973
376,673322,13,18,0,-3,0,3,0.698612949973
377,675108,2,30,0,-3,7,10,0.697809249973
378,676894,4,30,0,0,10,10,0.697005549973
379,678680,0,19,0,-4,6,10,0.696201849973
380,680466,0,18,0,1,6,5,0.695398149972
381,682252,17,18,0,-3,6,9,0.694594449972
382,684038,0,23,0,1,1,0,0.693790749972
383,685824,1,18,0,4,9,5,0.692987049972
384,687610,0,26,0,3,12,9,0.692183349972
385,689396,0,18,0,1,6,5,0.691379649972
386,691182,14,29,0,8,14,6,0.690575949972
387,692968,8,18,0,4,8,4,0.689772249972
388,694754,2,18,0,2,4,2,0.688968549972
389,696540,0,25,0,-2,9,11,0.688164849972
390,698326,14,18,0,-3,7,10,0.687361149972
391,700112,0,21,0,-2,9,11,0.686557449972
392,701898,0,18,0,6,11,5,0.685753749972
393,703684,17,32,0,2,13,11,0.684950049972
394,705470,4,18,0,-1,3,4,0.684146349971
395,707256,0,18,0,-3,4,7,0.683342649971
396,709042,6,33,0,-1,1,2,0.682538949971
397,710828,9,24,0,0,14,14,0.681735249971
398,712614,8,18,0,-5,8,13,0.680931549971
399,714400,0,18,0,3,14,11,0.680127849971
400,716186,17,18,0,-2,3,5,0.679324149971
401,717972,13,19,0,-1,16,17,0.678520449971
402,719758,0,18,0,-2,5,7,0.677716749971
403,721544,0,18,0,-1,12,13,0.676913049971
404,723330,0,31,0,0,5,5,0.676109349971
405,725116,0,18,0,-8,2,10,0.675305649971
406,726902,0,18,0,-6,8,14,0.674501949971
407,728688,14,18,0,-5,2,7,0.67369824997
408,730474,0,30,0,-3,6,9,0.67289454997
409,732260,15,18,0,-5,8,13,0.67209084997
410,734046,7,18,0,-1,9,10,0.67128714997
411,735832,16,32,0,0,5,5,0.67048344997
412,737618,9,19,0,-3,15,18,0.66967974997
413,739404,3,18,0,1,8,7,0.66887604997
414,741190,0,18,0,10,17,7,0.66807234997
415,742976,0,34,0,0,2,2,0.66726864997
416,744762,0,18,0,-1,9,10,0.66646494997
417,746548,0,18,0,10,15,5,0.66566124997
418,748334,14,18,0,-2,3,5,0.66485754997
419,750120,15,18,0,4,13,9,0.66405384997
420,751906,1,25,0,4,8,4,0.66325014997
421,753692,0,18,0,-1,6,7,0.662446449969
422,755478,0,24,0,7,9,2,0.661642749969
423,757264,6,18,0,-2,2,4,0.660839049969
424,759050,0,18,0,0,16,16,0.660035349969
425,760836,4,18,0,-4,7,11,0.659231649969
426,762622,6,24,0,11,18,7,0.658427949969
427,764408,1,18,0,8,14,6,0.657624249969
428,766194,16,35,0,-2,2,4,0.656820549969
429,767980,0,21,0,-4,2,6,0.656016849969
430,769766,0,18,0,6,9,3,0.655213149969
431,771552,11,29,0,5,8,3,0.654409449969
432,773338,15,20,0,-4,5,9,0.653605749969
433,775124,12,18,0,-9,7,16,0.652802049969
434,776910,7,18,0,11,15,4,0.651998349969
435,778696,15,18,0,1,4,3,0.651194649968
436,780482,12,34,0,-2,4,6,0.650390949968
437,782268,1,18,0,6,17,11,0.649587249968
438,784054,0,18,0,2,2,0,0.648783549968
439,785840,10,27,0,2,15,13,0.647979849968
440,787626,7,21,0,-1,21,22,0.647176149968
441,789412,5,18,0,1,7,6,0.646372449968
442,791198,12,18,0,21,36,15,0.645568749968
443,792984,0,18,0,4,9,5,0.644765049968
444,794770,0,28,0,5,10,5,0.643961349968
445,796556,14,30,0,4,9,5,0.643157649968
446,798342,3,18,0,1,8,7,0.642353949968
447,800128,9,18,0,-13,5,18,0.641550249968
448,801914,0,35,0,3,13,10,0.640746549968
449,803700,15,35,0,18,27,9,0.639942849967
450,805486,1,22,0,5,9,4,0.639139149967
451,807272,0,32,0,3,8,5,0.638335449967
452,809058,0,18,0,0,4,4,0.637531749967
453,810844,14,23,0,2,8,6,0.636728049967
454,812630,0,18,0,3,16,13,0.635924349967
455,814416,0,18,0,-3,4,7,0.635120649967
456,816202,12,24,0,-5,3,8,0.634316949967
457,817988,0,18,0,-3,4,7,0.633513249967
458,819774,9,33,0,-9,8,17,0.632709549967
459,821560,13,18,0,1,14,13,0.631905849967
460,823346,4,18,0,4,7,3,0.631102149967
461,825132,9,18,0,-3,8,11,0.630298449967
462,826918,3,18,0,3,9,6,0.629494749966
463,828704,0,18,0,0,3,3,0.628691049966
464,830490,16,24,0,1,8,7,0.627887349966
465,832276,0,28,0,0,7,7,0.627083649966
466,834062,3,22,0,3,3,0,0.626279949966
467,835848,3,28,0,3,9,6,0.625476249966
468,837634,0,18,0,-5,11,16,0.624672549966
469,839420,16,18,0,7,9,2,0.623868849966
470,841206,7,18,0,11,17,6,0.623065149966
471,842992,13,31,0,-1,17,18,0.622261449966
472,844778,17,21,0,3,9,6,0.621457749966
473,846564,4,30,0,4,13,9,0.620654049966
474,848350,0,18,0,4,16,12,0.619850349966
475,850136,7,35,0,-3,1,4,0.619046649966
476,851922,11,18,0,17,34,17,0.618242949965
477,853708,0,18,0,7,9,2,0.617439249965
478,855494,15,18,0,6,11,5,0.616635549965
479,857280,0,18,0,14,16,2,0.615831849965
480,859066,0,18,0,3,5,2,0.615028149965
481,860852,0,29,0,4,10,6,0.614224449965
482,862638,13,18,0,-4,5,9,0.613420749965
483,864424,0,18,0,10,26,16,0.612617049965
484,866210,0,18,0,1,7,6,0.611813349965
485,867996,0,18,0,0,3,3,0.611009649965
486,869782,4,26,0,25,30,5,0.610205949965
487,871568,0,18,0,-4,7,11,0.609402249965
488,873354,5,18,0,9,19,10,0.608598549965
489,875140,15,18,0,0,12,12,0.607794849965
490,876926,17,22,0,4,9,5,0.606991149964
491,878712,0,18,0,-2,3,5,0.606187449964
492,880498,10,18,0,7,10,3,0.605383749964
493,882284,7,18,0,15,24,9,0.604580049964
494,884070,5,18,0,5,10,5,0.603776349964
495,885856,0,18,0,3,7,4,0.602972649964
496,887642,14,18,0,5,11,6,0.602168949964
497,889428,0,18,0,-7,11,18,0.601365249964
498,891214,10,18,0,2,7,5,0.600561549964
499,893000,0,24,0,5,9,4,0.599757849964
500,894786,5,18,0,12,16,4,0.598954149964
501,896572,14,18,0,-9,3,12,0.598150449964
502,898358,14,18,0,11,12,1,0.597346749964
503,900144,14,18,0,-5,1,6,0.596543049964
504,901930,4,18,0,-1,5,6,0.595739349963
505,903716,5,18,0,3,11,8,0.594935649963
506,905502,15,18,0,-2,0,2,0.594131949963
507,907288,7,28,0,2,10,8,0.593328249963
508,909074,2,18,0,-5,1,6,0.592524549963
509,910860,10,18,0,4,12,8,0.591720849963
510,912646,4,18,0,8,13,5,0.590917149963
511,914432,0,33,0,5,19,14,0.590113449963
512,916218,0,18,0,17,24,7,0.589309749963
513,918004,15,18,0,-3,2,5,0.588506049963
514,919790,0,18,0,11,17,6,0.587702349963
515,921576,8,20,0,-6,9,15,0.586898649963
516,923362,0,32,0,3,11,8,0.586094949963
517,925148,11,18,0,-3,5,8,0.585291249962
518,926934,0,31,0,6,10,4,0.584487549962
519,928720,0,18,0,2,4,2,0.583683849962
520,930506,1,18,0,8,11,3,0.582880149962
521,932292,6,18,0,15,19,4,0.582076449962
522,934078,1,18,0,16,18,2,0.581272749962
523,935864,0,35,0,4,6,2,0.580469049962
524,937650,6,25,0,7,8,1,0.579665349962
525,939436,0,18,0,-2,5,7,0.578861649962
526,941222,0,18,0,-3,0,3,0.578057949962
527,943008,14,23,0,4,10,6,0.577254249962
528,944794,10,30,0,1,8,7,0.576450549962
529,946580,0,18,0,3,5,2,0.575646849962
530,948366,15,18,0,3,13,10,0.574843149962
531,950152,10,18,0,-4,1,5,0.574039449961
532,951938,16,33,0,4,5,1,0.573235749961
533,953724,0,25,0,4,9,5,0.572432049961
534,955510,0,18,0,6,7,1,0.571628349961
535,957296,0,18,0,3,5,2,0.570824649961
536,959082,2,18,0,21,26,5,0.570020949961
537,960868,0,21,0,4,4,0,0.569217249961
538,962654,13,22,0,9,15,6,0.568413549961
539,964440,8,18,0,-3,1,4,0.567609849961
540,966226,4,18,0,3,9,6,0.566806149961
541,968012,15,18,0,0,11,11,0.566002449961
542,969798,17,18,0,0,3,3,0.565198749961
543,971584,16,18,0,3,5,2,0.564395049961
544,973370,5,18,0,4,9,5,0.563591349961
545,975156,2,18,0,2,8,6,0.56278764996
546,976942,0,35,0,3,6,3,0.56198394996
547,978728,0,18,0,2,6,4,0.56118024996
548,980514,17,18,0,18,21,3,0.56037654996
549,982300,0,33,0,10,18,8,0.55957284996
550,984086,0,18,0,2,15,13,0.55876914996
551,985872,12,18,0,3,10,7,0.55796544996
552,987658,15,18,0,6,6,0,0.55716174996
553,989444,0,24,1,2,8,6,0.55635804996
554,991230,0,18,0,4,11,7,0.55555434996
555,993016,0,18,0,4,4,0,0.55475064996
556,994802,1,18,0,9,14,5,0.55394694996
557,996588,3,29,0,-4,4,8,0.55314324996
558,998374,0,18,0,8,9,1,0.55233954996
559,1000160,5,18,0,8,13,5,0.551535849959
560,1001946,8,20,0,5,9,4,0.550732149959
561,1003732,0,31,0,4,4,0,0.549928449959
562,1005518,2,18,0,-1,1,2,0.549124749959
563,1007304,0,18,0,3,7,4,0.548321049959
564,1009090,0,18,0,6,7,1,0.547517349959
565,1010876,0,34,0,3,3,0,0.546713649959
566,1012662,12,30,0,17,23,6,0.545909949959
567,1014448,6,22,0,1,3,2,0.545106249959
568,1016234,0,32,0,9,16,7,0.544302549959
569,1018020,0,30,0,1,3,2,0.543498849959
570,1019806,0,33,0,19,23,4,0.542695149959
571,1021592,0,18,0,8,10,2,0.541891449959
572,1023378,12,18,0,2,8,6,0.541087749958
573,1025164,2,18,0,7,14,7,0.540284049958
574,1026950,2,18,0,7,9,2,0.539480349958
575,1028736,0,33,0,0,9,9,0.538676649958
576,1030522,0,18,0,1,3,2,0.537872949958
577,1032308,0,32,0,2,2,0,0.537069249958
578,1034094,7,18,0,0,7,7,0.536265549958
579,1035880,2,18,0,12,13,1,0.535461849958
580,1037666,0,18,0,9,11,2,0.534658149958
581,1039452,2,32,0,19,29,10,0.533854449958
582,1041238,0,18,0,7,15,8,0.533050749958
583,1043024,0,34,0,2,9,7,0.532247049958
584,1044810,6,24,0,10,14,4,0.531443349958
585,1046596,5,18,0,-2,3,5,0.530639649958
586,1048382,0,18,0,6,6,0,0.529835949957
587,1050168,0,18,0,25,30,5,0.529032249957
588,1051954,11,18,0,4,10,6,0.528228549957
589,1053740,9,18,0,1,5,4,0.527424849957
590,1055526,13,35,0,3,9,6,0.526621149957
591,1057312,1,18,0,0,0,0,0.525817449957
592,1059098,9,18,0,20,23,3,0.525013749957
593,1060884,13,19,0,10,14,4,0.524210049957
594,1062670,11,35,0,-1,4,5,0.523406349957
595,1064456,0,18,0,5,5,0,0.522602649957
596,1066242,12,18,0,4,6,2,0.521798949957
597,1068028,10,18,0,2,6,4,0.520995249957
598,1069814,5,18,0,2,8,6,0.520191549957
599,1071600,3,18,0,4,11,7,0.519387849957
600,1073386,0,18,0,1,12,11,0.518584149956
601,1075172,15,18,0,1,8,7,0.517780449956
602,1076958,0,18,0,3,7,4,0.516976749956
603,1078744,0,18,0,3,10,7,0.516173049956
604,1080530,0,18,0,8,10,2,0.515369349956
605,1082316,2,35,0,5,11,6,0.514565649956
606,1084102,0,18,0,-2,5,7,0.513761949956
607,1085888,2,33,0,8,10,2,0.512958249956
608,1087674,9,18,0,6,9,3,0.512154549956
609,1089460,4,18,0,7,12,5,0.511350849956
610,1091246,0,33,0,4,5,1,0.510547149956
611,1093032,0,18,0,-2,1,3,0.509743449956
612,1094818,0,33,0,-1,6,7,0.508939749956
613,1096604,5,18,0,-2,12,14,0.508136049956
614,1098390,11,27,0,3,6,3,0.507332349955
615,1100176,0,18,0,5,5,0,0.506528649955
616,1101962,0,18,0,5,7,2,0.505724949955
617,1103748,0,18,0,-1,7,8,0.504921249955
618,1105534,0,32,0,12,13,1,0.504117549955
619,1107320,0,18,0,7,20,13,0.503313849955
620,1109106,2,31,0,6,7,1,0.502510149955
621,1110892,0,18,0,-6,7,13,0.501706449955
622,1112678,0,18,0,6,10,4,0.500902749955
623,1114464,11,18,0,18,25,7,0.500099049955
624,1116250,8,18,0,-3,2,5,0.499295349955
625,1118036,17,18,0,13,16,3,0.498491649955
626,1119822,0,27,0,1,6,5,0.497687949955
627,1121608,0,27,0,-2,7,9,0.496884249955
628,1123394,0,18,0,1,2,1,0.496080549955
629,1125180,4,18,0,0,0,0,0.495276849955
630,1126966,0,18,0,-2,2,4,0.494473149955
631,1128752,0,18,0,-1,8,9,0.493669449955
632,1130538,10,34,0,4,17,13,0.492865749955
633,1132324,5,18,0,10,18,8,0.492062049955
634,1134110,10,18,0,1,3,2,0.491258349955
635,1135896,0,18,0,9,11,2,0.490454649955
636,1137682,0,32,0,2,4,2,0.489650949955
637,1139468,10,18,0,0,0,0,0.488847249955
638,1141254,0,18,0,4,4,0,0.488043549955
639,1143040,8,20,0,0,1,1,0.487239849955
640,1144826,0,18,0,7,9,2,0.486436149955
641,1146612,4,18,0,13,14,1,0.485632449955
642,1148398,0,18,0,7,12,5,0.484828749955
643,1150184,0,18,0,0,5,5,0.484025049955
644,1151970,6,18,0,1,6,5,0.483221349955
645,1153756,0,18,0,14,23,9,0.482417649955
646,1155542,13,18,0,5,10,5,0.481613949955
647,1157328,7,18,0,5,6,1,0.480810249955
648,1159114,10,18,0,0,3,3,0.480006549955
649,1160900,4,28,0,2,5,3,0.479202849955
650,1162686,1,18,0,2,8,6,0.478399149955
651,1164472,0,18,0,-4,2,6,0.477595449956
652,1166258,1,18,0,4,4,0,0.476791749956
653,1168044,0,18,0,0,3,3,0.475988049956
654,1169830,11,18,0,2,11,9,0.475184349956
655,1171616,4,25,0,8,12,4,0.474380649956
656,1173402,0,18,0,27,29,2,0.473576949956
657,1175188,13,18,0,9,11,2,0.472773249956
658,1176974,14,26,0,1,5,4,0.471969549956
659,1178760,0,18,0,6,12,6,0.471165849956
660,1180546,12,18,0,6,11,5,0.470362149956
661,1182332,6,18,0,22,25,3,0.469558449956
662,1184118,5,18,0,1,1,0,0.468754749956
663,1185904,9,18,0,10,12,2,0.467951049956
664,1187690,4,18,0,1,8,7,0.467147349956
665,1189476,0,18,0,9,12,3,0.466343649956
666,1191262,0,18,0,7,15,8,0.465539949956
667,1193048,0,18,0,5,8,3,0.464736249956
668,1194834,0,18,0,4,14,10,0.463932549956
669,1196620,0,18,0,1,3,2,0.463128849956
670,1198406,0,18,0,-3,1,4,0.462325149956
671,1200192,0,18,0,2,8,6,0.461521449956
672,1201978,0,18,0,4,9,5,0.460717749956
673,1203764,0,18,0,6,12,6,0.459914049956
674,1205550,0,18,0,1,3,2,0.459110349956
675,1207336,10,18,0,3,3,0,0.458306649956
676,1209122,2,31,0,12,16,4,0.457502949956
677,1210908,0,18,0,-3,0,3,0.456699249956
678,1212694,0,20,0,1,3,2,0.455895549956
679,1214480,0,31,0,5,7,2,0.455091849956
680,1216266,0,18,0,25,29,4,0.454288149956
681,1218052,0,18,0,7,16,9,0.453484449956
682,1219838,0,27,0,4,9,5,0.452680749956
683,1221624,17,18,0,8,16,8,0.451877049956
684,1223410,0,18,0,3,11,8,0.451073349956
685,1225196,0,18,0,12,20,8,0.450269649956
686,1226982,0,18,0,2,7,5,0.449465949956
687,1228768,12,26,0,5,18,13,0.448662249956
688,1230554,0,18,0,3,4,1,0.447858549956
689,1232340,2,18,0,7,13,6,0.447054849957
690,1234126,1,18,0,5,7,2,0.446251149957
691,1235912,0,27,0,10,14,4,0.445447449957
692,1237698,0,18,0,1,4,3,0.444643749957
693,1239484,0,18,0,3,8,5,0.443840049957
694,1241270,0,18,0,2,8,6,0.443036349957
695,1243056,0,27,0,6,11,5,0.442232649957
696,1244842,0,18,0,2,4,2,0.441428949957
697,1246628,0,18,0,0,6,6,0.440625249957
698,1248414,1,18,0,19,27,8,0.439821549957
699,1250200,0,18,0,4,7,3,0.439017849957
700,1251986,5,18,0,4,13,9,0.438214149957
701,1253772,0,18,0,-2,1,3,0.437410449957
702,1255558,13,18,0,3,4,1,0.436606749957
703,1257344,10,34,0,-1,3,4,0.435803049957
704,1259130,4,18,0,7,13,6,0.434999349957
705,1260916,0,30,0,7,12,5,0.434195649957
706,1262702,0,18,0,0,7,7,0.433391949957
707,1264488,0,24,0,6,7,1,0.432588249957
708,1266274,0,18,0,9,14,5,0.431784549957
709,1268060,0,18,0,6,12,6,0.430980849957
710,1269846,0,18,0,23,35,12,0.430177149957
711,1271632,0,18,0,2,3,1,0.429373449957
712,1273418,15,18,0,7,7,0,0.428569749957
713,1275204,4,27,0,-1,2,3,0.427766049957
714,1276990,17,18,0,4,6,2,0.426962349957
715,1278776,0,30,0,3,4,1,0.426158649957
716,1280562,0,18,0,1,2,1,0.425354949957
717,1282348,0,30,0,3,6,3,0.424551249957
718,1284134,0,18,0,2,8,6,0.423747549957
719,1285920,0,18,0,2,5,3,0.422943849957
720,1287706,0,35,0,0,0,0,0.422140149957
721,1289492,0,18,0,11,14,3,0.421336449957
722,1291278,15,18,0,-1,7,8,0.420532749957
723,1293064,0,18,0,-2,4,6,0.419729049957
724,1294850,3,18,0,0,4,4,0.418925349957
725,1296636,0,34,0,15,19,4,0.418121649957
726,1298422,0,18,0,7,9,2,0.417317949958
727,1300208,0,18,0,3,8,5,0.416514249958
728,1301994,0,32,0,4,10,6,0.415710549958
729,1303780,0,24,0,10,10,0,0.414906849958
730,1305566,0,26,0,6,10,4,0.414103149958
731,1307352,7,32,0,6,13,7,0.413299449958
732,1309138,13,18,0,7,16,9,0.412495749958
733,1310924,0,18,0,0,0,0,0.411692049958
734,1312710,1,18,0,17,21,4,0.410888349958
735,1314496,9,18,0,11,15,4,0.410084649958
736,1316282,0,18,0,-3,5,8,0.409280949958
737,1318068,0,18,0,3,3,0,0.408477249958
738,1319854,0,18,0,3,7,4,0.407673549958
739,1321640,5,18,0,9,12,3,0.406869849958
740,1323426,11,18,0,3,3,0,0.406066149958
741,1325212,0,28,0,8,12,4,0.405262449958
742,1326998,0,18,0,3,4,1,0.404458749958
743,1328784,0,18,0,-1,3,4,0.403655049958
744,1330570,17,18,0,5,8,3,0.402851349958
745,1332356,12,22,0,6,13,7,0.402047649958
746,1334142,0,22,0,2,3,1,0.401243949958
747,1335928,0,28,0,16,22,6,0.400440249958
748,1337714,2,18,0,9,15,6,0.399636549958
749,1339500,0,18,0,7,7,0,0.398832849958
750,1341286,0,22,0,11,18,7,0.398029149958
751,1343072,7,18,0,4,8,4,0.397225449958
752,1344858,0,18,0,13,16,3,0.396421749958
753,1346644,12,18,0,4,12,8,0.395618049958
754,1348430,9,18,0,0,0,0,0.394814349958
755,1350216,0,18,0,-1,0,1,0.394010649958
756,1352002,0,18,0,6,6,0,0.393206949958
757,1353788,3,18,0,0,0,0,0.392403249958
758,1355574,0,18,0,2,4,2,0.391599549958
759,1357360,0,18,0,-1,6,7,0.390795849958
760,1359146,5,18,0,-3,0,3,0.389992149958
761,1360932,0,18,0,1,7,6,0.389188449958
762,1362718,3,18,0,8,11,3,0.388384749958
763,1364504,0,32,0,-1,5,6,0.387581049958
764,1366290,0,18,0,-2,12,14,0.386777349959
765,1368076,0,35,0,4,7,3,0.385973649959
766,1369862,17,18,0,0,0,0,0.385169949959
767,1371648,0,18,0,0,3,3,0.384366249959
768,1373434,16,18,0,21,25,4,0.383562549959
769,1375220,0,31,0,0,2,2,0.382758849959
770,1377006,8,18,0,2,8,6,0.381955149959
771,1378792,0,24,0,5,9,4,0.381151449959
772,1380578,8,18,0,6,7,1,0.380347749959
773,1382364,0,18,0,1,13,12,0.379544049959
774,1384150,0,18,0,2,5,3,0.378740349959
775,1385936,0,18,0,-2,12,14,0.377936649959
776,1387722,11,18,0,4,5,1,0.377132949959
777,1389508,0,18,0,1,3,2,0.376329249959
778,1391294,11,18,0,6,14,8,0.375525549959
779,1393080,0,30,0,0,9,9,0.374721849959
780,1394866,0,18,0,3,3,0,0.373918149959
781,1396652,0,32,0,12,15,3,0.373114449959
782,1398438,0,19,0,-2,5,7,0.372310749959
783,1400224,0,18,0,10,13,3,0.371507049959
784,1402010,7,18,0,-1,1,2,0.370703349959
785,1403796,2,18,0,1,2,1,0.369899649959
786,1405582,0,23,0,-3,1,4,0.369095949959
787,1407368,0,18,0,-3,9,12,0.368292249959
788,1409154,0,18,0,2,8,6,0.367488549959
789,1410940,0,20,0,-2,4,6,0.366684849959
790,1412726,12,18,0,0,4,4,0.365881149959
791,1414512,14,29,0,6,14,8,0.365077449959
792,1416298,6,26,0,9,12,3,0.364273749959
793,1418084,0,18,0,0,4,4,0.363470049959
794,1419870,0,18,0,10,16,6,0.362666349959
795,1421656,0,33,0,1,10,9,0.361862649959
796,1423442,0,18,0,0,5,5,0.361058949959
797,1425228,0,18,0,4,6,2,0.360255249959
798,1427014,4,18,0,3,3,0,0.359451549959
799,1428800,0,18,0,5,8,3,0.358647849959
800,1430586,0,18,0,2,3,1,0.357844149959
801,1432372,0,18,0,-2,7,9,0.357040449959
802,1434158,0,18,0,-2,13,15,0.35623674996
803,1435944,0,32,0,-3,2,5,0.35543304996
804,1437730,0,18,0,2,8,6,0.35462934996
805,1439516,0,18,0,0,0,0,0.35382564996
806,1441302,0,18,0,10,11,1,0.35302194996
807,1443088,0,26,0,33,39,6,0.35221824996
808,1444874,0,18,0,0,5,5,0.35141454996
809,1446660,0,18,0,4,4,0,0.35061084996
810,1448446,0,35,0,-2,3,5,0.34980714996
811,1450232,0,22,0,4,4,0,0.34900344996
812,1452018,0,18,0,1,4,3,0.34819974996
813,1453804,0,24,0,-7,10,17,0.34739604996
814,1455590,4,18,0,-1,5,6,0.34659234996
815,1457376,0,18,0,5,5,0,0.34578864996
816,1459162,0,18,0,15,21,6,0.34498494996
817,1460948,0,18,0,5,13,8,0.34418124996
818,1462734,0,27,0,-2,4,6,0.34337754996
819,1464520,1,34,0,7,9,2,0.34257384996
820,1466306,0,18,0,0,5,5,0.34177014996
821,1468092,0,21,0,2,6,4,0.34096644996
822,1469878,0,18,0,3,8,5,0.34016274996
823,1471664,2,18,0,11,16,5,0.33935904996
824,1473450,0,28,0,2,5,3,0.33855534996
825,1475236,0,18,0,5,11,6,0.33775164996
826,1477022,0,18,0,2,5,3,0.33694794996
827,1478808,0,18,0,11,17,6,0.33614424996
828,1480594,0,35,0,7,9,2,0.33534054996
829,1482380,0,31,0,6,8,2,0.33453684996
830,1484166,0,18,0,2,11,9,0.33373314996
831,1485952,0,18,0,8,13,5,0.33292944996
832,1487738,0,18,0,1,2,1,0.33212574996
833,1489524,0,18,0,6,6,0,0.33132204996
834,1491310,3,18,0,-4,1,5,0.33051834996
835,1493096,0,18,0,-1,5,6,0.32971464996
836,1494882,0,18,0,2,14,12,0.32891094996
837,1496668,5,18,0,5,7,2,0.32810724996
838,1498454,0,18,0,-1,4,5,0.32730354996
839,1500240,0,21,0,0,2,2,0.32649984996
840,1502026,0,18,0,3,3,0,0.325696149961
841,1503812,0,22,0,-2,8,10,0.324892449961
842,1505598,0,19,0,0,8,8,0.324088749961
843,1507384,9,18,0,-3,0,3,0.323285049961
844,1509170,7,18,0,7,8,1,0.322481349961
845,1510956,4,18,0,2,3,1,0.321677649961
846,1512742,0,28,0,11,16,5,0.320873949961
847,1514528,0,18,0,2,4,2,0.320070249961
848,1516314,0,18,0,2,4,2,0.319266549961
849,1518100,0,22,0,1,6,5,0.318462849961
850,1519886,0,18,0,0,8,8,0.317659149961
851,1521672,0,18,0,5,5,0,0.316855449961
852,1523458,9,29,0,9,14,5,0.316051749961
853,1525244,0,18,0,0,0,0,0.315248049961
854,1527030,0,18,0,3,10,7,0.314444349961
855,1528816,0,18,0,4,4,0,0.313640649961
856,1530602,0,18,0,3,10,7,0.312836949961
857,1532388,0,18,0,1,1,0,0.312033249961
858,1534174,1,18,0,3,7,4,0.311229549961
859,1535960,0,28,0,2,4,2,0.310425849961
860,1537746,2,18,0,-1,0,1,0.309622149961
861,1539532,11,24,0,1,1,0,0.308818449961
862,1541318,0,18,0,8,12,4,0.308014749961
863,1543104,0,34,0,2,5,3,0.307211049961
864,1544890,0,32,0,-1,6,7,0.306407349961
865,1546676,0,32,0,7,8,1,0.305603649961
866,1548462,0,20,0,-4,0,4,0.304799949961
867,1550248,3,25,0,2,3,1,0.303996249961
868,1552034,9,18,0,5,6,1,0.303192549961
869,1553820,0,27,0,5,8,3,0.302388849961
870,1555606,0,18,0,3,7,4,0.301585149961
871,1557392,0,34,0,3,4,1,0.300781449961
872,1559178,13,18,0,0,5,5,0.299977749961
873,1560964,0,18,0,-2,0,2,0.299174049961
874,1562750,4,24,0,0,0,0,0.298370349961
875,1564536,0,18,0,2,4,2,0.297566649961
876,1566322,0,18,0,0,2,2,0.296762949961
877,1568108,0,25,0,2,5,3,0.295959249962
878,1569894,0,18,0,0,2,2,0.295155549962
879,1571680,0,18,0,1,7,6,0.294351849962
880,1573466,0,18,0,3,4,1,0.293548149962
881,1575252,14,18,0,6,10,4,0.292744449962
882,1577038,6,18,0,4,6,2,0.291940749962
883,1578824,16,23,0,0,6,6,0.291137049962
884,1580610,0,18,0,5,9,4,0.290333349962
885,1582396,0,18,0,0,8,8,0.289529649962
886,1584182,6,21,0,3,12,9,0.288725949962
887,1585968,0,18,0,2,8,6,0.287922249962
888,1587754,0,18,0,-3,2,5,0.287118549962
889,1589540,0,18,0,6,7,1,0.286314849962
890,1591326,0,19,0,0,0,0,0.285511149962
891,1593112,17,18,0,5,11,6,0.284707449962
892,1594898,1,18,0,-6,0,6,0.283903749962
893,1596684,0,22,0,6,9,3,0.283100049962
894,1598470,0,18,0,1,8,7,0.282296349962
895,1600256,0,31,0,1,1,0,0.281492649962
896,1602042,6,25,0,3,4,1,0.280688949962
897,1603828,0,28,0,7,8,1,0.279885249962
898,1605614,0,18,0,1,3,2,0.279081549962
899,1607400,0,18,0,7,12,5,0.278277849962
900,1609186,0,28,0,0,0,0,0.277474149962
901,1610972,0,20,0,6,7,1,0.276670449962
902,1612758,5,23,0,7,11,4,0.275866749962
903,1614544,0,18,0,2,10,8,0.275063049962
904,1616330,0,18,0,6,12,6,0.274259349962
905,1618116,0,18,0,-2,8,10,0.273455649962
906,1619902,0,26,0,6,15,9,0.272651949962
907,1621688,0,18,0,5,6,1,0.271848249962
908,1623474,0,18,0,2,4,2,0.271044549962
909,1625260,0,18,0,1,5,4,0.270240849962
910,1627046,15,29,0,12,15,3,0.269437149962
911,1628832,0,18,0,4,8,4,0.268633449962
912,1630618,0,18,0,0,2,2,0.267829749962
913,1632404,0,18,0,-1,4,5,0.267026049962
914,1634190,0,18,0,8,10,2,0.266222349962
915,1635976,14,18,0,4,7,3,0.265418649963
916,1637762,0,18,0,-1,3,4,0.264614949963
917,1639548,0,34,0,2,4,2,0.263811249963
918,1641334,0,24,0,2,9,7,0.263007549963
919,1643120,0,18,0,1,10,9,0.262203849963
920,1644906,2,34,0,1,2,1,0.261400149963
921,1646692,0,19,0,5,6,1,0.260596449963
922,1648478,0,34,0,1,3,2,0.259792749963
923,1650264,13,24,0,-2,3,5,0.258989049963
924,1652050,0,18,0,5,6,1,0.258185349963
925,1653836,0,18,0,3,3,0,0.257381649963
926,1655622,0,18,0,3,6,3,0.256577949963
927,1657408,0,18,0,14,19,5,0.255774249963
928,1659194,0,29,0,5,8,3,0.254970549963
929,1660980,0,18,0,8,11,3,0.254166849963
930,1662766,0,18,0,2,7,5,0.253363149963
931,1664552,0,18,0,-8,5,13,0.252559449963
932,1666338,0,18,0,-8,5,13,0.251755749963
933,1668124,0,22,0,2,3,1,0.250952049963
934,1669910,0,24,0,0,5,5,0.250148349963
935,1671696,0,18,0,2,2,0,0.249344649963
936,1673482,0,18,0,0,4,4,0.248540949963
937,1675268,0,18,0,1,4,3,0.247737249963
938,1677054,6,18,0,-1,8,9,0.246933549963
939,1678840,0,18,0,4,10,6,0.246129849963
940,1680626,17,18,0,0,5,5,0.245326149963
941,1682412,17,25,0,5,11,6,0.244522449963
942,1684198,0,18,0,3,11,8,0.243718749963
943,1685984,0,18,0,0,8,8,0.242915049963
944,1687770,0,18,0,-1,3,4,0.242111349963
945,1689556,0,18,0,4,11,7,0.241307649963
946,1691342,0,18,0,1,3,2,0.240503949963
947,1693128,0,18,0,-1,2,3,0.239700249963
948,1694914,0,27,0,3,5,2,0.238896549963
949,1696700,6,18,0,2,4,2,0.238092849963
950,1698486,0,18,0,2,4,2,0.237289149963
951,1700272,13,33,0,8,11,3,0.236485449963
952,1702058,0,18,0,-3,0,3,0.235681749963
953,1703844,0,18,0,4,8,4,0.234878049963
954,1705630,0,18,0,0,4,4,0.234074349963
955,1707416,0,27,0,10,12,2,0.233270649963
956,1709202,15,18,0,-1,3,4,0.232466949963
957,1710988,0,18,0,3,18,15,0.231663249962
958,1712774,0,18,0,3,7,4,0.230859549962
959,1714560,0,18,0,-1,1,2,0.230055849962
960,1716346,0,18,0,-2,3,5,0.229252149962
961,1718132,4,18,0,13,21,8,0.228448449962
962,1719918,0,18,0,7,14,7,0.227644749962
963,1721704,0,25,0,2,2,0,0.226841049962
964,1723490,0,33,0,3,10,7,0.226037349962
965,1725276,0,18,0,0,0,0,0.225233649962
966,1727062,0,18,0,2,2,0,0.224429949962
967,1728848,0,18,0,-1,5,6,0.223626249962
968,1730634,0,33,0,7,12,5,0.222822549962
969,1732420,0,18,0,2,4,2,0.222018849962
970,1734206,0,19,0,5,13,8,0.221215149962
971,1735992,16,35,0,1,6,5,0.220411449962
972,1737778,0,18,0,1,8,7,0.219607749962
973,1739564,0,18,0,0,13,13,0.218804049962
974,1741350,0,23,0,10,11,1,0.218000349962
975,1743136,7,18,0,2,13,11,0.217196649962
976,1744922,0,18,0,-4,3,7,0.216392949962
977,1746708,0,18,0,0,4,4,0.215589249962
978,1748494,17,18,0,-6,6,12,0.214785549962
979,1750280,0,18,0,2,2,0,0.213981849962
980,1752066,6,18,0,-1,3,4,0.213178149962
981,1753852,0,18,0,3,9,6,0.212374449962
982,1755638,0,19,0,-3,2,5,0.211570749962
983,1757424,4,18,0,1,3,2,0.210767049962
984,1759210,0,18,0,0,0,0,0.209963349962
985,1760996,0,27,0,1,4,3,0.209159649962
986,1762782,3,19,0,-1,10,11,0.208355949962
987,1764568,0,18,0,-2,3,5,0.207552249962
988,1766354,0,33,0,13,20,7,0.206748549962
989,1768140,0,20,0,2,5,3,0.205944849962
990,1769926,0,19,0,1,4,3,0.205141149962
991,1771712,3,28,0,4,5,1,0.204337449962
992,1773498,0,18,0,3,4,1,0.203533749962
993,1775284,0,27,0,13,16,3,0.202730049962
994,1777070,0,35,0,-2,11,13,0.201926349962
995,1778856,0,18,0,0,7,7,0.201122649962
996,1780642,2,23,0,-1,1,2,0.200318949962
997,1782428,0,33,0,0,3,3,0.199515249962
998,1784214,2,19,0,2,2,0,0.198711549962
999,1786000,0,22,0,3,6,3,0.197907849962
1000,1787786,0,34,0,0,0,0,0.197104149961
1001,1789572,0,19,0,2,11,9,0.196300449961
1002,1791358,0,18,0,-2,5,7,0.195496749961
1003,1793144,4,18,0,6,8,2,0.194693049961
1004,1794930,0,18,0,5,8,3,0.193889349961
1005,1796716,0,27,0,1,3,2,0.193085649961
1006,1798502,0,18,0,2,2,0,0.192281949961
1007,1800288,0,19,0,-5,0,5,0.191478249961
1008,1802074,0,31,0,-1,2,3,0.190674549961
1009,1803860,0,18,0,1,2,1,0.189870849961
1010,1805646,0,18,0,11,13,2,0.189067149961
1011,1807432,0,29,0,13,14,1,0.188263449961
1012,1809218,0,18,0,-2,0,2,0.187459749961
1013,1811004,0,18,0,-2,1,3,0.186656049961
1014,1812790,0,33,0,2,2,0,0.185852349961
1015,1814576,0,18,0,0,2,2,0.185048649961
1016,1816362,1,18,0,4,10,6,0.184244949961
1017,1818148,0,28,0,-1,5,6,0.183441249961
1018,1819934,0,18,0,1,2,1,0.182637549961
1019,1821720,0,18,0,-2,4,6,0.181833849961
1020,1823506,0,18,0,0,6,6,0.181030149961
1021,1825292,0,18,0,6,8,2,0.180226449961
1022,1827078,0,18,0,3,5,2,0.179422749961
1023,1828864,0,18,0,4,4,0,0.178619049961
1024,1830650,0,18,0,-4,1,5,0.177815349961
1025,1832436,0,18,0,-2,1,3,0.177011649961
1026,1834222,14,24,0,2,2,0,0.176207949961
1027,1836008,0,18,0,0,5,5,0.175404249961
1028,1837794,0,34,0,0,1,1,0.174600549961
1029,1839580,0,18,0,1,1,0,0.173796849961
1030,1841366,0,18,0,-1,0,1,0.172993149961
1031,1843152,0,18,0,-1,0,1,0.172189449961
1032,1844938,0,34,0,-4,2,6,0.171385749961
1033,1846724,8,18,0,0,0,0,0.170582049961
1034,1848510,0,35,0,-2,11,13,0.169778349961
1035,1850296,0,18,0,13,16,3,0.168974649961
1036,1852082,2,18,0,3,4,1,0.168170949961
1037,1853868,0,27,0,7,9,2,0.167367249961
1038,1855654,3,18,0,2,7,5,0.166563549961
1039,1857440,3,18,0,-6,12,18,0.165759849961
1040,1859226,0,21,0,0,0,0,0.164956149961
1041,1861012,0,18,0,3,6,3,0.164152449961
1042,1862798,0,18,0,-3,2,5,0.163348749961
1043,1864584,0,18,0,3,9,6,0.16254504996
1044,1866370,0,23,0,1,4,3,0.16174134996
1045,1868156,0,28,0,-6,2,8,0.16093764996
1046,1869942,0,18,0,2,5,3,0.16013394996
1047,1871728,0,18,0,2,5,3,0.15933024996
1048,1873514,5,18,0,0,2,2,0.15852654996
1049,1875300,0,18,0,5,9,4,0.15772284996
1050,1877086,0,18,0,-1,1,2,0.15691914996
1051,1878872,0,18,0,-6,11,17,0.15611544996
1052,1880658,0,18,0,3,9,6,0.15531174996
1053,1882444,10,18,0,0,4,4,0.15450804996
1054,1884230,0,18,0,0,6,6,0.15370434996
1055,1886016,0,18,0,-1,6,7,0.15290064996
1056,1887802,0,28,0,0,5,5,0.15209694996
1057,1889588,0,18,0,6,7,1,0.15129324996
1058,1891374,17,18,0,-5,6,11,0.15048954996
1059,1893160,0,19,0,-3,4,7,0.14968584996
1060,1894946,0,28,0,0,0,0,0.14888214996
1061,1896732,0,18,0,2,3,1,0.14807844996
1062,1898518,0,27,0,-3,0,3,0.14727474996
1063,1900304,0,18,0,-3,3,6,0.14647104996
1064,1902090,0,35,0,-4,7,11,0.14566734996
1065,1903876,5,25,0,-2,1,3,0.14486364996
1066,1905662,0,34,0,4,17,13,0.14405994996
1067,1907448,0,30,0,11,16,5,0.14325624996
1068,1909234,0,35,0,-6,9,15,0.14245254996
1069,1911020,0,35,0,2,2,0,0.14164884996
1070,1912806,0,18,0,1,7,6,0.14084514996
1071,1914592,0,18,0,0,0,0,0.14004144996
1072,1916378,0,18,0,-3,0,3,0.13923774996
1073,1918164,0,18,0,-2,10,12,0.13843404996
1074,1919950,0,18,0,0,2,2,0.13763034996
1075,1921736,0,21,0,5,5,0,0.13682664996
1076,1923522,0,29,0,0,0,0,0.13602294996
1077,1925308,0,35,0,-1,0,1,0.13521924996
1078,1927094,0,35,0,0,0,0,0.13441554996
1079,1928880,0,35,0,0,0,0,0.13361184996
1080,1930666,0,35,0,0,0,0,0.13280814996
1081,1932452,0,21,0,0,0,0,0.13200444996
1082,1934238,12,18,0,0,11,11,0.13120074996
1083,1936024,10,18,0,-3,2,5,0.13039704996
1084,1937810,0,18,0,0,3,3,0.12959334996
1085,1939596,0,18,0,1,1,0,0.12878964996
1086,1941382,0,18,0,0,7,7,0.12798594996
1087,1943168,0,18,0,-3,8,11,0.127182249959
1088,1944954,13,25,0,1,6,5,0.126378549959
1089,1946740,0,18,0,1,2,1,0.125574849959
1090,1948526,14,18,0,0,0,0,0.124771149959
1091,1950312,0,18,0,3,7,4,0.123967449959
1092,1952098,0,18,0,2,2,0,0.123163749959
1093,1953884,0,18,0,3,4,1,0.122360049959
1094,1955670,0,30,0,-3,1,4,0.121556349959
1095,1957456,13,18,0,0,3,3,0.120752649959
1096,1959242,0,18,0,4,5,1,0.119948949959
1097,1961028,0,18,0,-2,0,2,0.119145249959
1098,1962814,0,18,0,-2,6,8,0.118341549959
1099,1964600,0,18,0,-5,1,6,0.117537849959
1100,1966386,0,18,0,0,0,0,0.116734149959
1101,1968172,9,18,0,2,7,5,0.115930449959
1102,1969958,0,18,0,0,0,0,0.115126749959
1103,1971744,0,18,0,-2,1,3,0.114323049959
1104,1973530,0,33,0,-1,1,2,0.113519349959
1105,1975316,0,22,0,0,1,1,0.112715649959
1106,1977102,0,26,0,1,4,3,0.111911949959
1107,1978888,11,18,0,0,0,0,0.111108249959
1108,1980674,0,18,0,0,0,0,0.110304549959
1109,1982460,0,27,0,2,2,0,0.109500849959
1110,1984246,0,18,0,-1,1,2,0.108697149959
1111,1986032,0,18,0,4,8,4,0.107893449959
1112,1987818,0,18,0,-6,2,8,0.107089749959
1113,1989604,0,18,0,2,5,3,0.106286049959
1114,1991390,0,21,0,-5,6,11,0.105482349959
1115,1993176,0,18,0,4,4,0,0.104678649959
1116,1994962,8,18,0,2,4,2,0.103874949959
1117,1996748,0,18,0,1,4,3,0.103071249959
1118,1998534,0,18,0,2,4,2,0.102267549959
1119,2000320,0,18,0,-1,2,3,0.101463849959
1120,2002106,0,18,0,-2,0,2,0.100660149959
1121,2003892,0,30,0,4,7,3,0.0999999999595
1122,2005678,0,18,0,-1,2,3,0.0999999999595
1123,2007464,0,18,0,1,6,5,0.0999999999595
1124,2009250,0,18,0,-1,0,1,0.0999999999595
1125,2011036,0,18,0,1,2,1,0.0999999999595
1126,2012822,0,18,0,1,1,0,0.0999999999595
1127,2014608,0,33,0,0,0,0,0.0999999999595
1128,2016394,0,18,0,1,1,0,0.0999999999595
1129,2018180,17,18,0,0,0,0,0.0999999999595
1130,2019966,0,18,0,-5,2,7,0.0999999999595
1131,2021752,0,18,0,-2,0,2,0.0999999999595
1132,2023538,15,18,0,-5,1,6,0.0999999999595
1133,2025324,0,18,0,-4,9,13,0.0999999999595
1134,2027110,0,18,0,-1,0,1,0.0999999999595
1135,2028896,0,18,0,0,0,0,0.0999999999595
1136,2030682,0,18,0,0,0,0,0.0999999999595
1137,2032468,0,18,0,2,2,0,0.0999999999595
1138,2034254,0,22,0,0,0,0,0.0999999999595
1139,2036040,0,31,0,1,4,3,0.0999999999595
1140,2037826,0,18,0,0,0,0,0.0999999999595
1141,2039612,0,18,0,-4,1,5,0.0999999999595
1142,2041398,0,18,0,0,0,0,0.0999999999595
1143,2043184,0,18,0,-16,3,19,0.0999999999595
1144,2044970,0,18,0,1,2,1,0.0999999999595
1145,2046756,0,18,0,-1,3,4,0.0999999999595
1146,2048542,0,18,0,-2,1,3,0.0999999999595
1147,2050328,0,18,0,-2,1,3,0.0999999999595
1148,2052114,0,18,0,-5,2,7,0.0999999999595
1149,2053900,0,18,0,0,2,2,0.0999999999595
1150,2055686,0,18,0,-1,8,9,0.0999999999595
1151,2057472,0,18,0,-4,1,5,0.0999999999595
1152,2059258,14,27,0,2,3,1,0.0999999999595
1153,2061044,0,18,0,0,0,0,0.0999999999595
1154,2062830,5,18,0,1,2,1,0.0999999999595
1155,2064616,1,21,0,0,0,0,0.0999999999595
1156,2066402,0,18,0,0,0,0,0.0999999999595
1157,2068188,0,18,0,-9,0,9,0.0999999999595
1158,2069974,0,18,0,0,0,0,0.0999999999595
1159,2071760,0,26,0,-4,3,7,0.0999999999595
1160,2073546,0,27,0,3,3,0,0.0999999999595
1161,2075332,5,18,0,2,9,7,0.0999999999595
1162,2077118,0,18,0,0,2,2,0.0999999999595
1163,2078904,0,30,0,-2,0,2,0.0999999999595
1164,2080690,0,18,0,0,0,0,0.0999999999595
1165,2082476,0,18,0,-2,4,6,0.0999999999595
1166,2084262,0,18,0,-3,0,3,0.0999999999595
1167,2086048,0,18,0,1,2,1,0.0999999999595
1168,2087834,0,35,0,-1,1,2,0.0999999999595
1169,2089620,0,18,0,1,3,2,0.0999999999595
1170,2091406,0,18,0,-1,1,2,0.0999999999595
1171,2093192,0,18,0,-1,0,1,0.0999999999595
1172,2094978,0,18,0,-1,0,1,0.0999999999595
1173,2096764,0,23,0,2,2,0,0.0999999999595
1174,2098550,0,19,0,0,0,0,0.0999999999595
1175,2100336,0,18,0,-5,5,10,0.0999999999595
1176,2102122,0,18,0,-1,0,1,0.0999999999595
1177,2103908,0,26,0,0,6,6,0.0999999999595
1178,2105694,1,18,0,0,0,0,0.0999999999595
1179,2107480,0,34,0,0,1,1,0.0999999999595
1180,2109266,0,18,0,0,1,1,0.0999999999595
1181,2111052,6,18,0,-1,3,4,0.0999999999595
1182,2112838,0,18,0,2,2,0,0.0999999999595
1183,2114624,0,18,0,0,2,2,0.0999999999595
1184,2116410,0,18,0,2,3,1,0.0999999999595
1185,2118196,0,18,0,-5,4,9,0.0999999999595
1186,2119982,0,32,0,0,0,0,0.0999999999595
1187,2121768,0,18,0,-1,3,4,0.0999999999595
1188,2123554,0,18,0,-1,3,4,0.0999999999595
1189,2125340,0,18,0,7,8,1,0.0999999999595
1190,2127126,3,18,0,-1,0,1,0.0999999999595
1191,2128912,0,18,0,-8,0,8,0.0999999999595
1192,2130698,0,18,0,0,1,1,0.0999999999595
1193,2132484,0,18,0,-1,0,1,0.0999999999595
1194,2134270,0,18,0,-2,3,5,0.0999999999595
1195,2136056,0,18,0,-8,0,8,0.0999999999595
1196,2137842,0,18,0,-7,8,15,0.0999999999595
1197,2139628,0,18,0,-3,4,7,0.0999999999595
1198,2141414,0,18,0,-1,1,2,0.0999999999595
1199,2143200,14,29,0,0,2,2,0.0999999999595
1200,2144986,10,18,0,-2,0,2,0.0999999999595
